************************
*......................*
*.****...*.............*
*....*...*.****..*.....*
*....*...*....*..*.....*
*....*...*....*..*.....*
*....*........*..*.....*
*.******......*........*
*......................*
*...*....*....*****....*
*...*....*.............*
*...*....*......*......*
*...*....****...*......*
*...............*......*
*......................*
************************